##########
#...@....#
#ll......#
#..####..#
#.....#..#
#.....#..#
#..e..#..#
#........#
#........#
##########
