##########
#...@....#
#ll......#
#..####..#
#........#
#........#
#.....#..#
#.S......#
#........#
##########
