##########
#...@....#
#ll..z...#
#........#
#........#
#.z......#
#....z...#
#........#
#........#
##########
